11111111111111111111111111100000
00000000000000000000000000100000
00000000000000000000000000100000
00000000000000000000000000100000
00000000000000000000000000100000
00000111111111111111111111100000
00000100000000000000000000000000
00000100000000000000000000000000
00000100000000000000000000000000
00000100000001111111111110000000
00000100000001000000000010000000
00000100000001000000000010000000
00000100000001000000000010000000
00000111111111000000000010000000
00000000000000000000000010000000
00000000000000000000000010000000
00000000000000000000000010000000
00000000000000000000000010000000
00000000000000000000000010000000
00000000000000000000000010000000
00000111111111111111111110000000
00000100000000000000000000000000
00000111111111111111111111111111
00000000000000000000000000000000


